111111111
100000001
100010111
1100P00E1
1010001C1
111111111